-22
28
-10
26
000000000000000000000000000000000000000000000000000
111111111111111111111111111111111111111111111111110
100000000000000000011111111111111111111331111111110
100000000011111111111111111110001111110330001111110
100000001110000000001111100000000000000330000000010
100000001000000000001111100000000000000000000000010
100000010000400004000111111000000000000000000000010
100000010000000100000111111000000000000010000000010
100000010000000100000011111100004000000010000000010
100000010004000100000011111100000000000010000000110
100000001000000100400011111110000000000010000000110
100040001100000000000001111111000400000000000001110
100000000010000000000001111111000000000000000001110
100000000010000000001100111111110000000000000001110
100400400010000000011110011111111000000000000001110
100000000010000011111111011111111000000000000001110
100000000100000011111111001111111100000000000001110
100000000100000000111100001111111110000000000001110
100000000100000000011000000000000000000000000001110
100010001000000000000000000111111111000000000001110
100001001000000000000000000001111111100000000111110
100000000000000000000400000001111111100040001111110
100000001000000000000000400001111111100000000011110
100000011000000000000000000000111111110000000011110
100000010000000000000000000000111111110040040011110
100000010000000000000004000000111111111000000011110
100000010000000000000000000000011111111100000011110
100000110000000000000000000000011111111100000011110
100000100000011000000000000000001111111111000001110
100000100000011000000000000000011111111111111001110
100000100000011000000000011111111111111111111111110
100010100000000000000000000001100111111111111111110
100000100000000000000111100000010011111111111111110
100000100000000000001111100000100011111111111111110
100100100000000000111111110000000011111111111111110
100000100000000111111111111101100111111111111111110
111111122222222111111111111111111111111111111111110
