-22
28
-10
26
000000000000000000000000000000000000000000000000000
111111111111113333111111111111111111111111111111110
111111111111110000111111111111111111111111111111110
111111111111110000111111111111111111111111111111110
111111111111110000111111111111111111111111111111110
111111111111110000111111111111111111111111111111110
111111110000000000000000000000000000000011111111110
111111110000000000000000400000000000004011111111110
111111110000000000111111111111111000000011111111110
111111110000040000111111111111111000000001111111110
111111110040000000111111111111111000000001111111110
111111110000000000111111111111110000000000111111110
111111110000004000000000000000000000000400111111110
111111110004000000000000000004000000000000011111110
111111110000000000000400000000000000000000011111110
111111110000000000000000001111000000004000011111110
111111110000000000000000001111000000000000011111110
111111110000000000000000001111000000000000011111110
111111111000040000000000001111000000011004011111110
111111111004000000000000000000000000111000011111110
111111111000000000000004004000000000111000011111110
111111111000400000000000000000000000111000011111110
111111111000000000000000040000000000111000011111110
111111111100000000000000000000000000111000011111110
111111111100000000000000000000000000010040011111110
111111111100000000000000000000000000000001111111110
111111111110000000400000000000000000000001111111110
111111111110000000000040000000000000000001111111110
111111111110000000000000000000000000000001111111110
111111111110000000040000000000000000000001111111110
111111111110000000000000000000000000000001111111110
111111111111111111111100000011110000000001111111110
111111111111111111111111111111111100000001111111110
111111111111111111111111111111111100000001111111110
111111111111111111111111111111111100000001111111110
111111111111111111111111111111111100000001111111110
111111111111111111111111111111111122222221111111110
