-22
28
-10
26
000000000000000000000000000000000000000000000000000
111111111111111111111111111111111111111111111111110
111111111111111111111111111111111111111111111111110
111111111111111111111111111111111111111111111111110
111111111111111111111111111111111111111111111111110
111111111100000000000111111111111111000000000111110
111111100000001111111111111111111111111111000111110
111111000001111111111111000011111111111111100111110
111111000011111111111000000000011111111111100111110
111110000011111110000000000000000000001111100111110
111110000011111100000000010000000000001111100111110
111100000011111000000000000000001000000111100011110
111100000011110000001000000000001000000111100011110
111110000011110000000000000000000000000111110011110
111110000111110010000000000000000000000111110011110
111110000011110000000000000000000000000111110011110
111110000011110000000000000000000000100111110011110
111110000011110000001000000000000000000111110011110
111110000011110000000000000000000000000111110011110
111110000011110000000000000000001000000111110011110
111110000011110010000000000000000000100111110011110
111110000011110000000000000000000000000111110011110
111110000011110000001000000000000000000111110011110
111110000011110000000000000000000000000111110011110
111110000011110000000000000000000000000111100011110
111110000011111111111111110001111111111111100011110
111110000011111111111111110001111111111111100011110
111110000011111111111111110001111111111111000011110
111110000001111111111111110001111111111110000011110
111110000000000000001111110001110000000000000011110
111110000000000000000001112221110000000000000011110
111110101111000111111001111111110000000000000111110
111111111111111111111111111111111111111111111111110
111111111111111111111111111111111111111111111111110
111111111111111111111111111111111111111111111111110
111111111111111111111111111111111111111111111111110
111111111111111111111111111111111111111111111111110
