-22
28
-10
26
000000000000000000000000000000000000000000000000000
111111111111103333011111111111111111111111111111110
111111111111100000011111111111111111111111111111110
111111111111100000011111111111111111111111111111110
111111110001100000011111111111111111111111111111110
111111100000000000000000000000000000000000001111110
111111100000000000000000000000000000000000001111110
111111100000000000000000400000000000004000000111110
111111100000000000111111111111111000000000000111110
111111100000040000111111111111111000000000011111110
111111100040000000111111111111111000000000011111110
111111100000000000111111111111110000000000001111110
111111000000004000000111111111100000000400001111110
111111000004000000000000000114000000000000000111110
111111000000000000000400000000000000000000000111110
111111000000000000000000001111000000004000000111110
111111000000000000000000001111000000000000000111110
111111000000000000000000001111000000000000000111110
111111000000040000000000001111000000011004000111110
111111000004000000000000000000000000111000000111110
111111100000000000000000000000000000111100000111110
111111100000400000000011000000000000111100000111110
111111100000000000000111100000000000111100000111110
111111100000000110000011100000400000111000000111110
111111100000000110000001000400000000010040000111110
111111100000000110000000000000000000000000000111110
111111110000000110400000000000400000000000001111110
111111110000000000000040000000000000000000011111110
111111111000000000000000000000000000000000011111110
111111111000000000040000000000000000000000011111110
111111111000000000000000000000000000000000011111110
111111111110000000000000000000000000000000011111110
111111111111111111000000000000000000000000011111110
111111111111111111111111111111110000000000111111110
111111111111111111111111111111111000000000111111110
111111111111111111111111111111111000000000111111110
111111111111111111111111111111111022222220111111110
