-22
28
-10
26
000000000000000000000000000000000000000000000000000
111111111111111111111111111111111111111111111111110
111111111111111111111111111111111111111111111111110
111111111111111111111111111111111111110000001111110
111111111100000000000000011111110000000000000000000
111111110000000000000000011111110000000000000000030
111111100000000000040004011111110000400000000000030
111111100000000000000000011111110000000000000011110
111111100000000000000000011111110040000000000111110
111111110000000000000040000000000000000000000111110
111111111000000000000000000000000000000000000111110
111111111100000000000000000000000001100000001111110
111111111100000000000000000000000011100000001111110
111111111100000000001111111111111111000040001111110
111111111100000000011111111111111100000000001111110
111111111100000001111111111111111100004000001111110
111111111000000001111111111111110000000000001111110
111111111000400000111101110000000000000004001111110
111111111000000000011000000000000000000000001111110
111111110000000000000000000000000000000000001111110
111111110000000040000000000000000000000000001111110
111111110000400000000000000000000000000000001111110
111111110000000000000000000000000000000000001111110
111111100000000000000000000111110000000000001111110
111111100000000000000000001111111110000000001111110
111111100000000000000000011111111111000000001111110
111111100000000000000000111111111111000000001111110
111111000000000000000001111111111111000000001111110
111111000000000000000011111111111111000000001111110
111111000000000000000111111111111111000000001111110
111111000000000000000111111111111111100000001111110
111111000000000000001111111111111111111000011111110
111111000000000000001111111111111111111111111111110
111111000000000000001111111111111111111111111111110
111111000000000000011111111111111111111111111111110
111111000000000111111111111111111111111111111111110
111111222222222111111111111111111111111111111111110
